#######################################################################
#........$.......#............#........#..######.......!!.....######..#
#....!..#######..#....#########.!.................#
#...........######.#####.........#######
#..#####........!#.......###########...#
###......@...#####....!.....##########.#
###########.......##....#..............#
#.............!!.........#######...#...#
#.$.......###########.............######
#....!.########################......!.#
###......#############............######
#....!..#.....$!...........########....#
#.....#######.........###............###
#$.!.............############.......#.$#
#.........####.......##................)
########################################
