#################################
#@.......#####..................#
#..####......#...#..#####.......#
#........#...#...#..............#
#........#...#...#..............#
#........#......................#
#........#......#############...#
#....##..#......#...............#
#...............................#
#......#######......#####.......#
#...........##......................
#################################
