#################################
#........#####......$$..........#
#..####.....!#...#..#####.......#
#........#...#...#..............#
#........#...#...#.........@....#
#...........##..................)..
#################################
