#################################
#........#......................#
#........#......................#
#........#......................#
#........#......................#
#........#......................#
#........#.......@..............#
#........#...#..................#
#...............................#
#...............................#
#.............................#
#################################
