#################################
#@.......#####......$$..........#
#..####.....!#...#..#####.......#
#........#...#...#..............#
#........#...#...#..............#
#........#......................#
#........#......#############...#
#....##..#......#...............#
#...............................#
#......#######......#####.......#
#...........##......................
#################################
