#################################
#........#####......$$..........#
#..####.....!#...#..#####.......#
#........#...#...#..............#
#........#...#...#.........@....#
#.....!..#......................#
#........#......#############...#
#....##..#......#...............#
#...............................#
#......#######......#####.......#
#...........##......................
#################################
