##################
#...............#
#....!..#######..#
#...........######
#..#####.........#
###......@...#####
###########......
#................#
##################