#######################################################################
#........$.......#............#........#..######.......!!.....######..#
#....!..#######..#....#########.!.................#
#...........######.#####.........#######
#..#####........!#.......###########...#
###......@.).#####....!.....##########.#
###########.......##....#..............#
#.............!!.........#######...#...#
#.$.......###########.............######
#....!.########################......!.#
###......#############............######
#....!..#.....$!...........########....#
#.....#######.........###............###
#$.!.............############.......#.$#
#.........####.......##.................
########################################