########################################
#........$.......#............#........#
#....!..#######..#....#########.!......#
#...........######.#####.........#######
#..#####........!#.......###########...#
###......@...#####....!.....##########.#
###########.......##....#..............#
#.............!!.........#######...#...#
#.$.......###########.............######
#....!.########################......!.#
###......#############............######
#....!..#.....$!...........########....#
#.....#######.........###............###
#$.!.............############.......#.$#
#.........####.......##.................
########################################