########################################.....
#........$.......#............#........#.....
#....!..#######..#....#########.!......#.....
#...........######.#####.........#######.....
#..#####........!#.......###########...#.....
###..........#####....!.....##########.#.....
###########.......##....#..............#....
#.............!!.....@...#######...#...)....
########################################.....
