##################
#...........@....#
#.......#######..#
#...........######
#..#####.........#
###..........#####
###########......
#................#
##################