#################################
#........#####......$$..........#
#..####.....!#...#..#####.......#
#........#...#...#..............#
#........#...#...#.......##...#
########....####..........@....)
################################
##############........##########
