#################################
#........#####......$$..........#
#..####.....!#...#..#####.......#
#........#...#...#..............#
#........#...#...#.........@....)
